^ ^ ^ ^ F F F F F F F F F ^ ^ ^ ^ F F F F F ^ ^ F F F F F F F F F F F F F F F F F F F F F F F F F F F F F F F F F F F F F F F F F F F F F F F F F F F F F F F G
 F ^ ^ ^ F F F F F F F F F ^ ^ ^ ^ F F F F F ^ ^ F F F F F F F F F F F F F F F F F F F F F F F F F F F F F F F F F F F F F F F F F F F F F F F F F F F F F F F G
 ^ F ^ ^ F F F F F F F F ^ ^ ^ ^ F F F F F F ^ ^ ^ F F F F F F F F F F F F F F F F F F F F F F F F F F F F F F F F F F F F F F F F F F F F F F F F F F F F F F F
 G ^ F F F F F F F F ^ F F ^ ^ ^ F F F F F ^ ^ ^ ^ ^ F F F F F F F F F F F F F F F F F F F F F F F F F F F F F F F F F F F F F F F F F F F F F F F F F F F F F G
 ^ ^ F F F F F F F F ^ F ^ ^ ^ ^ ^ ^ F F F ^ ^ ^ ^ ^ ^ F F F F F F F F F F F F F F F F F F F F F F F F F F F F F F F F F F F F F F F F F F F F F F F F F F F F F
 F F F F F F F F F F ^ ^ ^ ^ F F F F F F ^ ^ ^ ^ ^ ^ ^ F F F F F F F F F F F F F F F F F F F F F F F F F F F F F F F F F F F F F F F F F F F F F F F F F F F F F
 F ^ F F F F F F F F F ^ ^ F F F F F ^ ^ ^ ^ ^ ^ ^ ^ ^ F F F F F F F F F F F F F F F F F F F F F F F F F ~ ~ ~ ~ ~ ~ ~ ~ ~ ~ F F F F F F F F F F F F F F F F F F
 G F F F F F F F ^ F F ^ ^ F F F F F ^ ^ ^ ^ ^ ^ ^ ^ ^ F F F F F F F F F F F F F F F F F F F F F F F ~ ~ ~ ~ ~ ~ ~ ~ ~ ~ ~ ~ ~ ~ F F F F F F F F F F F F F F F F
 G G F F F F F F ^ F ^ ^ G F F F F F ^ ^ ^ ^ ^ ^ ^ ^ ^ F F F F F F F F F F F F F F F F F F F F F ~ ~ ~ ~ ~ ~ ~ ~ ~ ~ ~ ~ ~ ~ ~ ~ F F F F F F F F F F F F F F F F
 F F F F F F F F F ^ ^ ^ G G F F F F ^ F ^ ^ ^ ^ ^ ^ F F F F F F F F F F F F F F F F F F F F F F F F F ~ ~ ~ ~ ~ ~ F F F F F F F F F F F F F F F F F F F F F F G
 F F F F F F ^ ^ ^ ^ ^ G G F F F F F F G ^ ^ ^ ^ ^ F F F F F F F F F F F F F F F F F F F F F F F F F F F ~ ~ ~ F F F F ~ ~ F F F F F F F F F F F F F F F F F F ^
 F F F F F F ^ ^ ^ ^ ^ G G F F F F F G ^ ^ ^ ^ ^ ^ F F F F F F F F F F F F F F F F F F F F F F F F F F ~ ~ ~ ~ ~ ~ ~ ~ ~ ~ F F F F F F F F F F F F F F F F F F F
 F F F F F F G ^ ^ ^ ^ G G G F G F ^ ^ ^ ^ ^ ^ ^ ^ F F F F F F F F F F F F F F F F F F F F F F F ~ ~ ~ ~ ~ ~ ~ ~ ~ ~ F F F F F F F F F F F F F F F F F F F F F F
 F G ^ ^ ^ G G G ^ ^ ^ G G F F F ^ ^ ^ ^ ^ ^ ^ ^ ^ ^ F F F F F F F F F F F F F F F F F F F F F F F ~ ~ ~ ~ ~ ~ ~ ~ F F F F F F F F F F F F F F F F F F F F F F F
 G ^ G G G G G G ^ ^ G G G F G G G ^ ^ ^ ^ ^ ^ ^ ^ ^ F F F F F F F F F F F F F F F F F F F F F F F F F ~ ~ ~ ~ F F F F F F F F F F F F F F F F F F F F F F F F F
 F F G G G G G G G G F G F G G G G ^ ^ ^ ^ ^ ^ ^ ^ F F F F F F F F F F F F F F F F F F F F F F F F F F F F F F F F F F F F F F F F F F F F F F F F F F F F F F F
 ^ G G G G G G G G G G F F G G G ^ ^ ^ ^ ^ ^ ^ ^ F F F F F F F F F F F F F F F F F F F F F F F F F F F F F F F F F F F F F F F F F F F F F F F F F F F F F F F F
 G G G G G G G G G G F F G G G G ^ ^ ^ ^ ^ ^ ^ F F F F F F F F F F F F F F F F F F F F F F F F F F F F F F F F F F F F F F F F F F F F F F F F F F F F F F F F ^
 G G G G G G G G G G F F F G G G ^ ^ ^ ^ ^ ^ ^ F F F F F F F F F F F F F F F F F F F F F F F F F F F F F F F F F F F F F F F F F F F F F F F F F F F F F F F F F
 G G G G G G G G G F F F G G G G ^ ^ ^ ^ ^ ^ F F F F F F F F F F F F F F F F F F F F F F F F F F F F F F F F F F F F F F F F F F F F F F F F F F F F F F F F F ^
 G G G G G G G G F F F F G G G G ^ ^ ^ ^ ^ F F F ^ F F F F F F F F F F F F F F F F F F F F F F F F F F F F F F F F F F F F F F F F F F F F F F F F F F F F F F F
 G G G G G G G F F F F F F G G G ^ ^ ^ ^ F F F ^ ^ F F F F F F F F F F F F F F F F F F ^ F F F F F F F F F F F F F F F F F F F F F F F F F F F F F F F F F F F F
 G G G G G G F F F F F G G G G G ^ ^ ^ ^ F F ^ ^ ^ F F F F F F F F F F F F F F F F ^ ^ F F F F F F F F F F F F F F F F F F F F F F F F F F F F F F F F F F F F F
 G G G G G G F F F F F G G F G G ^ ^ ^ ^ F ^ ^ ^ ^ F F F F F F F F F F F F F F F F ^ ^ F F F F F F F F F F F F F F F F F F F F F F F F F F F F F F F F F F F G G
 G G G G G G G F F F F ^ F F G G G ^ ^ ^ ^ ^ ^ ^ F F F F F F F F F F F F F F G F ^ ^ ^ F F F F F F F F F F F F F F F F F F F G G G G G G F F F F F F F F F F F G
 G G G G G G G F F F F F G G G G ^ ^ ^ F ^ ^ ~ G F F F F F F F F F F F F F F ^ F ^ ^ F F F F F F F F F F F F F F F F F F G G G G G G G G F F F F F F F F F F F G
 F G G G G F F F F F F G G G G G ^ ^ ^ ^ ^ ~ ~ G F F F F F F F F F F F F F F F ^ ^ ^ F F F F F F F F F F F F F F F F F F G G G G G G G G F F F F F F F F F F F F
 G G G G G F F F F F G G G G G G ^ ^ ^ ^ ^ ~ ~ ~ F F F F F F F F F F F F F F ^ ^ ^ ^ F F F F F F F F F F F F F F F G G G G G G G G G G G G F F F F F F F F F F F
 G G G G G G F F F F F G G G G ^ ^ ^ ^ ^ ~ ~ ~ ~ F F F F F F F F F F F F F F ^ ^ ^ ^ F F F F F F F F F F F F F F F F G G G G G G G G G G G G F F F F F F F F F F
 G G F G G G F F F G G G G G ^ ^ ^ ^ ^ ^ ^ ~ ~ ~ ~ F F F F F F F F F F F F F ^ ^ ^ ^ F F F F F F F F F F F F F F F G G G G G G G G G G G G G F F F ~ F F F F F F
 F G G G G G F F F F G G G G ^ ^ ^ ^ ^ ^ ^ ^ ~ ~ F F F F F F F F F F F ^ F ^ F ^ ^ ^ F F F F F F F F F F F F F F G G G G G G G G G G G G G G F F F ~ F F F F F F
 F G G G G G F G G G G G G G ^ ^ ^ ^ ^ ^ ^ ^ ^ F F F F F F F F F F ^ ^ ^ F F ^ ^ ^ ^ F F F F F F F F F F F F F G G G G G G G G G G G G G G F F F ~ ~ F F F F F F
 F F G G G G G G G G G G G G G ^ ^ ^ ^ ^ ^ ^ G F F F F F F F F F F ^ ^ G ^ ^ ^ ^ ^ F F F F F F F F F F F F F G G G G G G G G G G G G G G G G F ~ ~ ~ F F F F F F
 G G G G G G G G G G G G G G G ^ ^ ^ ^ ^ ^ G G G F F F F F F F F F ^ G ^ ^ ^ ^ ^ ^ F F F F F F F F F F F F G G G G G G G G G G G G G G G G G G ~ ~ F F F F F F F
 G G G G G G G G G G G G G G G F ^ ^ ^ ^ ^ G G G F F F F F F F F F F ^ ^ ^ ^ ^ F F F F F F F F F F F F F F G G G G G G G G G G G G G G G G G F ~ ~ F F F F F F F
 G G G G G G G G G G G G G G F F F ^ ^ ^ G G G ^ F F F F F F F F F F ^ ^ ^ ^ F F F F F F F F F F F F F G G G G G G G G G G G G G G G G G G ~ ~ ~ ~ F F F F F F F
 G G G G G G G G G G G G G G ^ F ^ ^ ^ ^ G G G F F F F F F F F F F ^ ^ ^ ^ ^ ^ F F F F F F F F F F F F G G G G G G G G G G G G G G G G G G ~ ~ ~ F F F F F F F G
 G G G G G G G G G G G G G G ^ F F ^ G G G G G G F F F F F F F F ^ ^ ^ ^ ^ ^ ^ F F F F F F F F F F F G G G G G G G G G G G G G G G G G ~ ~ ~ ~ ~ ~ F F F F F F F
 G G G G G G G G G G G G G F F F F ^ ^ G G G ^ G F F F F F G F F ^ ^ ^ ^ ^ ^ ^ ^ F F F F F F F F F F G G G G G G G G G G G G G G G G G G ~ ~ ~ ~ ~ F F F F F G G
 G G G G G G G G G G G G G F F F F ^ F G G G G F F ^ F F G G G G ^ ^ F ^ ^ ^ ^ ^ F F F F F F F F F G G G G G G G G G G G F G G G G G G G G ~ ~ ~ F F F F G G G G
 G G G G G G G G G G G G G G F F F F G G G G F F F F ^ G G G G G ^ ^ ^ ^ ^ ^ ^ ^ F F G F F F F F F G G G G G G G G G G G F G G G G G G G F F F ~ F F F G G G G G
 G G G G G G G G G G G G G G F F ^ F G G G G ^ F F F ^ G G G G G ^ ^ ^ F F ^ G G G G G F F F F F G G G G G G G G G G G G G G G G G G G G G F F ~ F F F G G G G F
 G G G G G G G G G G G G G G G F F ^ G G G G G F F ^ ^ G G G G ^ ^ ^ ^ ^ G G G G G F F F F F F F G G G G G G G G G G G G G G G G G G G G G F ~ G F F G G G G F F
 G G G G G G G G G G G G G G G F F ^ G G G G F F F ^ ^ G G G ^ ^ ^ ^ G G G G G G G G F F F F F F G F G G G G G G G G G G G G G G G G G G G F ~ G F G G G G G G G
 G G G G G G G G G G G G G G F F F G G G G G F ^ ^ ^ ^ G G G ^ ^ ^ ^ G G G G G G G G F F F F G G G G G G G G G G G G G G G G G G F F F G G G ~ F G G G G G G G G
 G G G G G G F F G G G G G G G F F G G G G G ^ ^ ^ ^ ^ ^ G G G ^ G G G G G G G G G ^ F F G G G G G G G G G G G G G G G G G G G G G G G G G ^ ~ G G G G G G G F F
 G G G G G G F G G G G G G F F G G G G G G G G G G G G G G G G G G G G G G G G G G ^ G G G G G G G G G G G G G G G G G G G G G G G G G ^ ^ G ~ G G G G G G F F F
 G G G G G G G G G G G G G F G G G G G G G G G G G G G G G G G G G G G G G G G G G G G F F G G G G G G G G G G G G G G G G G G G G G G G G ~ ~ G G G G G F F F F
 G G G G G G G G G G G G G G G G G G G G G G G G G G G G G G G G G G G G G G G G G G G F F G G G G G G G G G G G G G G G G G G G G G G G G ~ ~ G G G G G G F G G
 G G G G G G G G G G G G G G G G G G G G G G G G G G G G G G G G G G G G G G G G G G G G G G G G G G G G G G G G G G G G G G G G G G G G G ~ ~ G G G G G G F G G